4 4 4 4 4 4 5 5 4 4 4 4 4 4 4 4
4 3 3 4 4 3 5 5 3 3 4 3 3 3 3 4
4 3 5 5 5 5 5 5 3 3 3 3 3 3 3 4
4 3 5 5 5 5 5 5 3 3 3 3 3 3 3 4
4 4 3 3 3 3 5 5 3 3 3 3 3 4 3 4
4 4 8 8 8 8 0 0 8 8 3 5 5 5 5 5
4 8 8 8 8 8 0 0 8 8 3 5 5 5 5 5
4 3 3 3 3 3 5 5 4 3 5 5 3 3 3 4
4 3 3 3 3 3 3 5 5 5 5 3 3 3 3 4
4 3 6 6 6 6 6 1 6 3 3 8 8 8 3 4
4 3 6 2 2 2 2 2 6 3 4 8 8 8 3 4
4 4 6 2 2 2 2 2 6 3 4 4 4 4 4 4
4 4 6 6 6 6 6 6 6 3 4 4 3 3 3 4
